|||||||||||||||||||||||||||||||||||||||
|*************************************|
|*|||||||*|||*|||||||||||*|||*|||||||*|
|*********|||*|||||||||||*|||*********|
|*|||||||*|||*|||||||||||*|||*|||||||*|
|*********|||*|||||||||||*|||*********|
|*|||||||||||*|||||||||||*|||||||||||*|
|*************************************|
|*||||||||||||||||*||*|||||||||||||||*|
|******************||*****************|
|*||||||||||||||||*||*|||||||||||||||*|
|*||||||||||||||||*||*|||||||||||||||*|
|*||||||||||||||||*||*|||||||||||||||*|
|*||||||||||||||||*||*|||||||||||||||*|
|*************************************|
|*|||||||*|||*|||||||||||*|||*|||||||*|
|*********|||*|||||||||||*|||*********|
|*|||||||*|||*|||||||||||*|||*|||||||*|
|*********|||*|||||||||||*|||*********|
|*|||||||||||*|||||||||||*|||||||||||*|
|*************************************|
|||||||||||||||||||||||||||||||||||||||
