|||||||||||||||||||||||||||||||||||||||
|*************************************|
|*|||||||||||*|||||||||||*|||||||||||*|
|*|||||||||||*|||||||||||*|||||||||||*|
|*|||||||||||*|||||||||||*|||||||||||*|
|*|||||||||||*|||||||||||*|||||||||||*|
|*|||||||||||*|||||||||||*|||||||||||*|
|*************************************|
|*|||||||||||*|||||||||||*|||||||||||*|
|*|||||||||||*|||||||||||*|||||||||||*|
|*|||||||||||*|||||||||||*|||||||||||*|
|*|||||||||||*|||||||||||*|||||||||||*|
|*|||||||||||*|||||||||||*|||||||||||*|
|*************************************|
|*|||||||||||*|||||||||||*|||||||||||*|
|*|||||||||||*|||||||||||*|||||||||||*|
|*|||||||||||*|||||||||||*|||||||||||*|
|*|||||||||||*|||||||||||*|||||||||||*|
|*|||||||||||*|||||||||||*|||||||||||*|
|*|||||||||||*|||||||||||*|||||||||||*|
|*************************************|
|||||||||||||||||||||||||||||||||||||||