|||||||||||||||||||||||||||||||||||||||
|*************************************|
|*|||||||||||||||||||||||||||||||||||*|
|*|||||||||||||||||||||||||||||||||||*|
|*|||||||||||||||||||||||||||||||||||*|
|*|||||||||||||||||||||||||||||||||||*|
|*|||||||||||||||||||||||||||||||||||*|
|*************************************|
|*|||||||||||||||||||||||||||||||||||*|
|*|||||||||||||||||||||||||||||||||||*|
|*|||||||||||||||||||||||||||||||||||*|
|*|||||||||||||||||||||||||||||||||||*|
|*|||||||||||||||||||||||||||||||||||*|
|*************************************|
|*|||||||||||||||||||||||||||||||||||*|
|*|||||||||||||||||||||||||||||||||||*|
|*|||||||||||||||||||||||||||||||||||*|
|*|||||||||||||||||||||||||||||||||||*|
|*|||||||||||||||||||||||||||||||||||*|
|*|||||||||||||||||||||||||||||||||||*|
|*************************************|
|||||||||||||||||||||||||||||||||||||||